1111111111111
100001C100001
100P00000E001
1000C00000001
1111111111111