1111111111111111111111111111111111
100000NN0000100C00000CN0000000N001
101001010011N100101001000N00010101
101001N01010E010001001000N00010101
1P0000000C00C000N0000000N0000000C1
1111111111111111111111111111111111